11111111111111111111
1C100000000000001C01
1000000N000100001101
1E100000001110000001
111000C00001P000N001
1000N000000000000001
11111111111111111111
