1111111111111111111111111111
1E00100000000000000000000001
1000111000000000000000000001
1P0000000000P000000000000001
100000000000000C000000000001
1000000000000000000000000001
1111111111111111111111111111
