1111111111111111111111111111
1C10000000000000000000000001
1C00000000000010000000000001
1E00000000000111000000000001
111000000000001P000000000001
1000000000000000000000000001
1111111111111111111111111111
